# torrc afl dictionary
# for afl-fuzz of .torrc parsing

arg_unit_bytes="bytes"
arg_unit_kbytes="KBytes"
arg_unit_mbytes="MBytes"
arg_unit_gbytes="GBytes"
arg_unit_kbits="KBits"
arg_unit_mbits="MBits"
arg_unit_gbits="GBits"
arg_transport_type="socks4"
arg_transport_type="socks5"
arg_transport_type="exec"
arg_ipaddr="127.0.0.1:9000"
arg_path="/tmp/file"
arg_bool_true="1"
arg_bool_false="0"
arg_int="100"
arg_maxint="9223372036854775807"
arg_key_relay="relay"
arg_key_stdin="stdin"
arg_key_stdout="stdout"
arg_dirname="/tmp"
arg_nodetype_entry="entry"
arg_nodetype_exit="exit"
arg_nodetype_rendezvous="rendezvous"
arg_nodetype_introduction="introduction"
arg_nodetype_middle="middle"
arg_auto="auto"
arg_cidr="127.0.0.1/32"
arg_policy_reject="reject *.*"
arg_policy_accept="accept *.*"


# args from tor documentation
# generated from script
bandwidthrate="BandwidthRate "
bandwidthburst="BandwidthBurst "
maxadvertisedbandwidth="MaxAdvertisedBandwidth "
relaybandwidthrate="RelayBandwidthRate "
relaybandwidthburst="RelayBandwidthBurst "
perconnbwrate="PerConnBWRate "
perconnbwburst="PerConnBWBurst "
clienttransportplugin="ClientTransportPlugin "
servertransportplugin="ServerTransportPlugin "
servertransportlistenaddr="ServerTransportListenAddr "
servertransportoptions="ServerTransportOptions "
extorportcookieauthfile="ExtORPortCookieAuthFile "
extorportcookieauthfilegroupreadable="ExtORPortCookieAuthFileGroupReadable "
connlimit="ConnLimit "
disablenetwork="DisableNetwork "
constrainedsockets="ConstrainedSockets "
constrainedsocksize="ConstrainedSockSize "
controlport="ControlPort "
controllistenaddress="ControlListenAddress "
controlsocket="ControlSocket "
controlsocketsgroupwritable="ControlSocketsGroupWritable "
hashedcontrolpassword="HashedControlPassword "
cookieauthentication="CookieAuthentication "
cookieauthfile="CookieAuthFile "
cookieauthfilegroupreadable="CookieAuthFileGroupReadable "
controlportwritetofile="ControlPortWriteToFile "
controlportfilegroupreadable="ControlPortFileGroupReadable "
datadirectory="DataDirectory "
fallbackdir="FallbackDir "
dirauthority="DirAuthority "
dirauthorityfallbackrate="DirAuthorityFallbackRate "
dynamicdhgroups="DynamicDHGroups "
alternatebridgeauthority="AlternateBridgeAuthority "
disableallswap="DisableAllSwap "
disabledebuggerattachment="DisableDebuggerAttachment "
fetchdirinfoearly="FetchDirInfoEarly "
fetchdirinfoextraearly="FetchDirInfoExtraEarly "
fetchhidservdescriptors="FetchHidServDescriptors "
fetchserverdescriptors="FetchServerDescriptors "
fetchuselessdescriptors="FetchUselessDescriptors "
httpproxy="HTTPProxy "
httpproxyauthenticator="HTTPProxyAuthenticator "
httpsproxy="HTTPSProxy "
httpsproxyauthenticator="HTTPSProxyAuthenticator "
sandbox="Sandbox "
socks4proxy="Socks4Proxy "
socks5proxy="Socks5Proxy "
socks5proxypassword="Socks5ProxyPassword "
sockssocketsgroupwritable="SocksSocketsGroupWritable "
keepaliveperiod="KeepalivePeriod "
log="Log "
log2="Log2 "
log4="Log4 "
logmessagedomains="LogMessageDomains "
outboundbindaddress="OutboundBindAddress "
pidfile="PidFile "
protocolwarnings="ProtocolWarnings "
predictedportsrelevancetime="PredictedPortsRelevanceTime "
runasdaemon="RunAsDaemon "
logtimegranularity="LogTimeGranularity "
truncatelogfile="TruncateLogFile "
safelogging="SafeLogging "
user="User "
hardwareaccel="HardwareAccel "
accelname="AccelName "
acceldir="AccelDir "
avoiddiskwrites="AvoidDiskWrites "
circuitpriorityhalflife="CircuitPriorityHalflife "
disableiocp="DisableIOCP "
userspaceiocpbuffers="UserspaceIOCPBuffers "
usefilteringsslbufferevents="UseFilteringSSLBufferevents "
countprivatebandwidth="CountPrivateBandwidth "
allowinvalidnodes="AllowInvalidNodes "
excludesinglehoprelays="ExcludeSingleHopRelays "
bridge="Bridge "
learncircuitbuildtimeout="LearnCircuitBuildTimeout "
circuitbuildtimeout="CircuitBuildTimeout "
circuitidletimeout="CircuitIdleTimeout "
circuitstreamtimeout="CircuitStreamTimeout "
clientonly="ClientOnly "
excludenodes="ExcludeNodes "
excludeexitnodes="ExcludeExitNodes "
geoipexcludeunknown="GeoIPExcludeUnknown "
exitnodes="ExitNodes "
entrynodes="EntryNodes "
strictnodes="StrictNodes "
fascistfirewall="FascistFirewall "
firewallports="FirewallPorts "
reachableaddresses="ReachableAddresses "
reachablediraddresses="ReachableDirAddresses "
reachableoraddresses="ReachableORAddresses "
hidservauth="HidServAuth "
closehsclientcircuitsimmediatelyontimeout="CloseHSClientCircuitsImmediatelyOnTimeout "
closehsservicerendcircuitsimmediatelyontimeout="CloseHSServiceRendCircuitsImmediatelyOnTimeout "
longlivedports="LongLivedPorts "
mapaddress="MapAddress "
newcircuitperiod="NewCircuitPeriod "
maxcircuitdirtiness="MaxCircuitDirtiness "
maxclientcircuitspending="MaxClientCircuitsPending "
nodefamily="NodeFamily "
enforcedistinctsubnets="EnforceDistinctSubnets "
socksport="SOCKSPort "
othersocksportflags="OtherSOCKSPortFlags "
sockslistenaddress="SOCKSListenAddress "
sockspolicy="SocksPolicy "
sockstimeout="SocksTimeout "
tokenbucketrefillinterval="TokenBucketRefillInterval "
trackhostexits="TrackHostExits "
trackhostexitsexpire="TrackHostExitsExpire "
updatebridgesfromauthority="UpdateBridgesFromAuthority "
usebridges="UseBridges "
useentryguards="UseEntryGuards "
useentryguardsasdirguards="UseEntryGuardsAsDirGuards "
guardfractionfile="GuardfractionFile "
useguardfraction="UseGuardFraction "
numentryguards="NumEntryGuards "
numdirectoryguards="NumDirectoryGuards "
guardlifetime="GuardLifetime "
safesocks="SafeSocks "
testsocks="TestSocks "
warnunsafesocks="WarnUnsafeSocks "
virtualaddrnetworkipv6="VirtualAddrNetworkIPv6 "
allownonrfc953hostnames="AllowNonRFC953Hostnames "
allowdotexit="AllowDotExit "
fastfirsthoppk="FastFirstHopPK "
transport="TransPort "
translistenaddress="TransListenAddress "
transproxytype="TransProxyType "
natdport="NATDPort "
natdlistenaddress="NATDListenAddress "
automaphostsonresolve="AutomapHostsOnResolve "
automaphostssuffixes="AutomapHostsSuffixes "
dnsport="DNSPort "
dnslistenaddress="DNSListenAddress "
clientdnsrejectinternaladdresses="ClientDNSRejectInternalAddresses "
clientrejectinternaladdresses="ClientRejectInternalAddresses "
downloadextrainfo="DownloadExtraInfo "
warnplaintextports="WarnPlaintextPorts "
rejectplaintextports="RejectPlaintextPorts "
allowsinglehopcircuits="AllowSingleHopCircuits "
optimisticdata="OptimisticData "
tor2webmode="Tor2webMode "
tor2webrendezvouspoints="Tor2webRendezvousPoints "
usemicrodescriptors="UseMicrodescriptors "
usentorhandshake="UseNTorHandshake "
pathbiasscalethreshold="PathBiasScaleThreshold "
pathbiasscaleusethreshold="PathBiasScaleUseThreshold "
clientuseipv6="ClientUseIPv6 "
clientpreferipv6orport="ClientPreferIPv6ORPort "
pathsneededtobuildcircuits="PathsNeededToBuildCircuits "
address="Address "
allowsinglehopexits="AllowSingleHopExits "
assumereachable="AssumeReachable "
bridgerelay="BridgeRelay "
contactinfo="ContactInfo "
exitpolicyrejectprivate="ExitPolicyRejectPrivate "
ipv6exit="IPv6Exit "
maxonionqueuedelay="MaxOnionQueueDelay "
myfamily="MyFamily "
nickname="Nickname "
numcpus="NumCPUs "
orport="ORPort "
orlistenaddress="ORListenAddress "
portforwarding="PortForwarding "
portforwardinghelper="PortForwardingHelper "
publishserverdescriptor="PublishServerDescriptor "
shutdownwaitlength="ShutdownWaitLength "
sslkeylifetime="SSLKeyLifetime "
heartbeatperiod="HeartbeatPeriod "
accountingmax="AccountingMax "
accountingrule="AccountingRule "
accountingstart="AccountingStart "
refuseunknownexits="RefuseUnknownExits "
serverdnsresolvconffile="ServerDNSResolvConfFile "
serverdnsallowbrokenconfig="ServerDNSAllowBrokenConfig "
serverdnssearchdomains="ServerDNSSearchDomains "
serverdnsdetecthijacking="ServerDNSDetectHijacking "
serverdnstestaddresses="ServerDNSTestAddresses "
serverdnsallownonrfc953hostnames="ServerDNSAllowNonRFC953Hostnames "
bridgerecordusagebycountry="BridgeRecordUsageByCountry "
serverdnsrandomizecase="ServerDNSRandomizeCase "
geoipfile="GeoIPFile "
geoipv6file="GeoIPv6File "
tlsecgroup="TLSECGroup "
cellstatistics="CellStatistics "
dirreqstatistics="DirReqStatistics "
entrystatistics="EntryStatistics "
exitportstatistics="ExitPortStatistics "
conndirectionstatistics="ConnDirectionStatistics "
hiddenservicestatistics="HiddenServiceStatistics "
extrainfostatistics="ExtraInfoStatistics "
extendallowprivateaddresses="ExtendAllowPrivateAddresses "
maxmeminqueues="MaxMemInQueues "
dirportfrontpage="DirPortFrontPage "
hidservdirectoryv2="HidServDirectoryV2 "
dirport="DirPort "
dirlistenaddress="DirListenAddress "
dirpolicy="DirPolicy "
authoritativedirectory="AuthoritativeDirectory "
v3authoritativedirectory="V3AuthoritativeDirectory "
versioningauthoritativedirectory="VersioningAuthoritativeDirectory "
recommendedversions="RecommendedVersions "
recommendedpackageversions="RecommendedPackageVersions "
recommendedclientversions="RecommendedClientVersions "
bridgeauthoritativedir="BridgeAuthoritativeDir "
minuptimehidservdirectoryv2="MinUptimeHidServDirectoryV2 "
recommendedserverversions="RecommendedServerVersions "
consensusparams="ConsensusParams "
dirallowprivateaddresses="DirAllowPrivateAddresses "
authdirbadexit="AuthDirBadExit "
authdirinvalid="AuthDirInvalid "
authdirreject="AuthDirReject "
authdirrejectccs="AuthDirRejectCCs "
authdirlistbadexits="AuthDirListBadExits "
authdirmaxserversperaddr="AuthDirMaxServersPerAddr "
authdirmaxserversperauthaddr="AuthDirMaxServersPerAuthAddr "
authdirfastguarantee="AuthDirFastGuarantee "
authdirguardbwguarantee="AuthDirGuardBWGuarantee "
bridgepassword="BridgePassword "
v3authvotinginterval="V3AuthVotingInterval "
v3authvotedelay="V3AuthVoteDelay "
v3authdistdelay="V3AuthDistDelay "
v3authnintervalsvalid="V3AuthNIntervalsValid "
v3bandwidthsfile="V3BandwidthsFile "
v3authuselegacykey="V3AuthUseLegacyKey "
rephisttracktime="RephistTrackTime "
voteonhidservdirectoriesv2="VoteOnHidServDirectoriesV2 "
authdirhasipv6connectivity="AuthDirHasIPv6Connectivity "
minmeasuredbwsforauthtoignoreadvertised="MinMeasuredBWsForAuthToIgnoreAdvertised "
hiddenservicedir="HiddenServiceDir "
hiddenserviceport="HiddenServicePort "
publishhidservdescriptors="PublishHidServDescriptors "
hiddenserviceversion="HiddenServiceVersion "
hiddenserviceauthorizeclient="HiddenServiceAuthorizeClient "
hiddenserviceallowunknownports="HiddenServiceAllowUnknownPorts "
rendpostperiod="RendPostPeriod "
hiddenservicedirgroupreadable="HiddenServiceDirGroupReadable "
testingtornetwork="TestingTorNetwork "
testingv3authinitialvotinginterval="TestingV3AuthInitialVotingInterval "
testingv3authinitialvotedelay="TestingV3AuthInitialVoteDelay "
testingv3authinitialdistdelay="TestingV3AuthInitialDistDelay "
testingv3authvotingstartoffset="TestingV3AuthVotingStartOffset "
testingauthdirtimetolearnreachability="TestingAuthDirTimeToLearnReachability "
testingestimateddescriptorpropagationtime="TestingEstimatedDescriptorPropagationTime "
testingminfastflagthreshold="TestingMinFastFlagThreshold "
testingserverdownloadschedule="TestingServerDownloadSchedule "
testingclientdownloadschedule="TestingClientDownloadSchedule "
testingserverconsensusdownloadschedule="TestingServerConsensusDownloadSchedule "
testingclientconsensusdownloadschedule="TestingClientConsensusDownloadSchedule "
testingbridgedownloadschedule="TestingBridgeDownloadSchedule "
testingclientmaxintervalwithoutrequest="TestingClientMaxIntervalWithoutRequest "
testingdirconnectionmaxstall="TestingDirConnectionMaxStall "
testingconsensusmaxdownloadtries="TestingConsensusMaxDownloadTries "
testingdescriptormaxdownloadtries="TestingDescriptorMaxDownloadTries "
testingmicrodescmaxdownloadtries="TestingMicrodescMaxDownloadTries "
testingcertmaxdownloadtries="TestingCertMaxDownloadTries "
testingdirauthvoteexit="TestingDirAuthVoteExit "
testingdirauthvoteguard="TestingDirAuthVoteGuard "
testingdirauthvotehsdir="TestingDirAuthVoteHSDir "
testingenableconnbwevent="TestingEnableConnBwEvent "
testingenablecellstatsevent="TestingEnableCellStatsEvent "
testingenabletbemptyevent="TestingEnableTbEmptyEvent "
testingminexitflagthreshold="TestingMinExitFlagThreshold "
